      D          F       D    
   ZZZHZZZZZZZZZZZZZZZZZZHZZZZ
      H                  H    
      H                  H    
      H                  H    
      S    D             S    
ZZZZZZZZZZZHZZZZZZZZZZZZZZZ   
           H                  
           H                  
           H                  
     E     S       D      E   
   ZZZZZZZZZZZZZZZZHZZZZZZZZZZ
                   H          
                   H          
                   H          
    E     D        S       E  
ZZZZZZZZZZHZZZZZZZZZZZZZZZZ   
          H                   
          H                   
          H                   
      D   S       E     D     
   ZZZHZZZZZZZZZZZZZZZZZHZZZZZ
      H                 H     
      H                 H     
      H                 H     
      S        P        S     
ZZZZZZZZZZZZZZZZZZZZZZZZZZZZZZ      
