      F
        D                     
ZZZZ  Z HZZZZZZ   E
        S     Z               
       ZZZ    Z               
ZZZZZZZZZZZZZZZZZZZZZZZZZ     
                           ZZZ
  D               E
ZZHZZZZZZZZZZZZZZZZZZZZZZZZ   
  H                 
  S                   D
ZZZZZZZZZZZZZZZ     ZZHZZ
                   E  H    Z
                  Z   S  DZZ  
                  ZZZZZZZHZZ  
                         H    
D           Z     E      S  ZZ
HZZZZZ      ZZZZZZZZZZZZZZZZZ 
H  Z             Z            
H  Z  P          Z            
H  Z             Z            
H  ZZZZ          Z            
H  Z             Z        D
H  ZZZZZZ  ZZZZZZZZZZ  ZZZHZZZ
H                         H   
H       ZZZZZ    ZZZZZZZZ H
H         Z               H   
H         Z               H   
S         Z               S   
ZZZZZZZZZZZZZZZZZZZZZZZZZZZZZZ
