 ED             D E     F  
ZZHZZZZZZZZZZZZZHZZZZZZZZZZZZZ
  H             H             
  H             H             
  H             H             
  S  E  D       S     D       
ZZZZZZZZHZZ   ZZZZZZZZHZZZZZZZ
        H             H       
        H             H       
        H             H       
        S  E  D       S   E D 
ZZZZZZZZZZZZZZHZZ   ZZZZZZZZHZ
              H             H 
              H             H 
              H             H 
   D      E   S     D       S 
ZZZHZZZZZZZZZZZZ  ZZHZZZZZZZZZ
   H                H         
   H                H         
   H                H         
   S  E   D         S    D    
ZZZZZZZZZZHZZZZ   ZZZZZZZHZZZZ
          H              H    
          H              H    
          H              H    
  P       S              S    
ZZZZZZZZZZZZZZZZZZZZZZZZZZZZZZ
