FFFFFFFFFFFFFFFFFFFFFFFFFFFFFFF
F                             F
F                             F
F                             F
F                             F
F                             F
F                             F
F                             F
F                             F
F                             F
F                             F
F                             F
F                             F
F                             F
F                             F
F                             F
F       ZZZZZ                 F
F                             F
F             ZZZZZ           F
F                             F
F       ZZZZZ                 F
F                             F
F                             F
F P                           F
F    ZZZZ                     F
F                             F
F       ZZZZ                  F
F                             F
F                             F
F                             F
FFFFFFFFFFFFFFFFFFFFFFFFFFFFFFF
